,0,8,10,18,20,28,30,38,40,48,50,58,60,68,70,78,80,88
0,,,,,,,1,,1,,1,,,,,,,
8,,,,,,1,,1,,1,,1,,,,,,
10,,,,,1,,21,,21,,21,,1,,,,,
18,,,,1,,21,,21,,21,,21,,1,,,,
20,,,1,,21,,41,,41,,41,,21,,1,,,
28,,,1,,21,,41,,41,,41,,21,,1,,,
30,,1,,21,,41,,71,,71,,41,,21,,1,,
38,,1,,21,,41,,71,,71,,41,,21,,1,,
40,1,,21,,41,,71,,,,71,,41,,21,,1,
48,1,,21,,41,,71,,,,71,,41,,21,,1,
50,1,,21,,41,,71,,,,71,,41,,21,,1,
58,,,,,,,,,,,,,,,,,,
60,,,,,,,,,,,,,,,,,,
68,,,,,,,,,,,,,,,,,,
